NO ./textures/Wall_N.xpm

SO ./textures/Wall_S.xpm

EA ./textures/Wall_E.xpm
    
WE ./textures/Wall_W.xpm

C 87,184,226
F 0,0,100



111111111111111111111111
100000000000000000000001
100000000000000000000001
100000000001000000000001
100000000000000000000001
10000000000000000000N001
111111111111111111111111