NO        ./textures/Wall_N.xpm    

SO      ./textures/Wall_S.xpm

EA           ./textures/Wall_E.xpm
    
C       0, 0,   125      
F       0,     5 ,   100   
WE        ./textures/Wall_W.xpm   



                                                                                                        
11111111111111111111111
10000000000000000000001
100000000000000000000001     1
10000000000100000000001  1 11
10000000000001000010N01      1         
10000000000000000000001
11111111111111111111111