NO ./textures/Wall_N.xpm

SO ./textures/Wall_S.xpm

EA ./textures/Wall_E.xpm
    
WE ./textures/Wall_W.xpm


F 255,100,0
C 220,100,0



1111111111111111111111111
100010100000000000000001
10001S000000000000000001
100000100000000000000001
100010111110000101010001
100010000010000000000001
100010100010000100010001
100010000010000000000001
100010110110000101010001
100000100000000000000001
100010100000000000000001
100010100000000000000001
100000100000000000000001
100010100000000000000001
100000100000000000000001
100000100000000000000001
111111111000000000000001
110110101000000000000001
110010101000000000000001
110110101000000000000001
110111111000000000000001
110010100000000000000001
111111111000000000000001
111111111111111111111111