NO ./textures/Wall_N.xpm
SO ./textures/Wall_S.xpm
EA ./textures/Wall_E.xpm
WE ./textures/Wall_W.xpm

C 0,0,42
F 0,0,15

                                    111 1

                                    111 1

                                    111 1


                                    1 111
                                    1 1 1
                                    111 1

                                    11 11
                                      1
                                    11111

                                    111 1
                                    1 11
                                    1 1
        1111111111111111111111111   11111
        1000000000110000000000001
        1011000001110000000000001   11111
        1001000000N00000000000001   1   1
1111111110110000011100000000000011  11111
1000000000110000011101111111111101
11110111111111011100000010001  111  111
11110111111111011101010000001          1
11000000110101011100000010001       111
10000000000000001100000010001          11 
10000000000000001101010010001       111
1100000111010101111101111000111
11110111 1110101 101111010001
11111111 1111111 111111111111       1
                                    11111
1 1 111 1 1 1                       1
 1  1 1  1  1
 1  111  1                          1   1
 1  1 1  1  1                       11111
                                    1   1

11111111111111111
10000000000000001
11111100000111111
     1000001
11111111111111111
10000000000000001
10000000000000001
10000000000000001
11111111111111111