NO         ./textures/Wall_N.xpm
SO    ./textures/Wall_S.xpm



EA   ./textures/Wall_E.xpm


  
C     0,0,42
F     0,0,12

WE  ./textures/Wall_W.xpm

                                                                                          
                                                                                            





 

                                            1
                                           111
                                          11011
                                         1100011
                                        110000001
                                 1111111000000111111111
                                  110000000000E0000011
                                   1100000000000000011
                                   11000000000000011
                                     110000111000011
                                      110011 110011
                                      11011   11011
                                     11011     11011
                                    11011       11011
                                   11111         10111
                                  111             1
                                                111
